"filename", "language", "Java", "comment", "blank", "total"
"d:\Java\EP1 OO\src\Aluno.java", "Java", 89, 1, 15, 105
"d:\Java\EP1 OO\src\AlunoEspecial.java", "Java", 14, 0, 6, 20
"d:\Java\EP1 OO\src\Avaliacao.java", "Java", 46, 0, 6, 52
"d:\Java\EP1 OO\src\Disciplina.java", "Java", 17, 0, 11, 28
"d:\Java\EP1 OO\src\JanelaAluno.java", "Java", 60, 0, 20, 80
"d:\Java\EP1 OO\src\JanelaAvaliacao_Frequencia.java", "Java", 2, 0, 2, 4
"d:\Java\EP1 OO\src\JanelaDisciplina_Turma.java", "Java", 2, 0, 2, 4
"d:\Java\EP1 OO\src\MainTeste.java", "Java", 11, 0, 2, 13
"d:\Java\EP1 OO\src\ModoAluno.java", "Java", 218, 0, 21, 239
"d:\Java\EP1 OO\src\ModoAvaliacao_Frequencia.java", "Java", 90, 0, 16, 106
"d:\Java\EP1 OO\src\ModoDisciplina_Turma.java", "Java", 169, 1, 27, 197
"d:\Java\EP1 OO\src\SistemaAcademico.java", "Java", 91, 0, 25, 116
"d:\Java\EP1 OO\src\Turmas.java", "Java", 51, 0, 5, 56
"Total", "-", 860, 2, 158, 1020